ads	ads
a	a
v	v
akak	akak
adad	adad
aaa	aaa
aff	aff
acca	acca
ccc	ccc
cvv	cvv
fff	fff
qww	qww
cvvc	cvvc
xcz	xcz
qrr	qrr
vnn	vnn
yuu	yuu
yii	yii
fgh	fgh
enn	enn
emm	emm
kal	kal
vbnm	vbnm
jjjn	jjjn
qrtt	qrtt
lkkk	lkkk
mmn	mmn
kkl	kkl
qrt	qrt
alk	alk
qwq	qwq
qrq	qrq
qss	qss
zsd	zsd
zzx	zzx
aas	aas
ert	ert
adas	adas
cvc	cvc
qqq	qqq
sss	sss
eee	eee
ddd	ddd
bbb	bbb
xzx	xzx
ttt	ttt
qqww	qqww
kkll	kkll
caa	caa
ffff	ffff
gggg	gggg
rrr	rrr
fafa	fafa
ddff	ddff
vvv	vvv
qwwe	qwwe
scc	scc
mmk	mmk
mcc	mcc
mnmc	mnmc
jaki	jaki
vvbv	vvbv
lalal	lalal
lolo	lolo
man	man
per	per
